..##..##..##..##..##..##..
..##..##..##..##..##..##..
..##..##..##..##..##..##..
..##..##..##..##..##..##..
..@@..@@..@@..@@..@@..@@..
..........................
........##......##........
##..##..##......##..##..##
##..######..##..######..##
##..##..##..##..##..##..##
@@..@@..@@..@@..@@..@@..@@
........@@......@@........
%%%%....##..%%..##....%%%%
%%%%....##..%%..##....%%%%
%%%%%%%%####%%####%%%%%%%%
%%%%%%%%##..%%..##%%%%%%%%
%%%%%%%%%%%%%%%%%%%%%%%%%%
%%%%%%%%%%%%%%%%%%%%%%%%%%
........##%%%%%%##........
##..##..##%%%%%%##..##..##
..##..##....%%....##..##..
..##..##....%%....##..##..
..##..##..........##..##..
..##..##...!!!!...##..##..
..##..##...!..!...##..##..
...........!..!...........
;
Fast,
Fast,
Fast,
Fast,
Armor,
Armor,
Armor,
Armor,
Armor,
Armor,
Armor,
Armor,
Basic,
Basic,
Basic,
Basic,
Power,
Power,
Power,
Power