.....................@@...
.....................@@...
....................@@....
............@@......@@....
............%%....###.....
..........##%%##..###.....
..........%%%%%%..###.....
........@@%%%%%%@@###.....
........%%%%--%%%%###.....
......##%%%%--%%%%###.....
......%%%%------%%%%#.....
....@@%%%%------%%%%#.....
....%%%%----------%%%%....
..##%%%%----------%%%%##..
..%%%%--------------%%%%..
@@%%%%--------------%%%%@@
%%%%------------------%%%%
%%%%------------------%%%%
..%%------------------%%..
..%%------------------%%..
..%%------------------%%..
..%%------------------%%..
..%%------......------%%..
..%%------.!!!!.------%%..
..%%----...!..!...----%%..
..%%----...!..!...----%%..
;
Fast,
Fast,
Armor,
Basic,
Basic,
Basic,
Basic,
Basic,
Basic,
Basic,
Basic,
Basic,
Basic,
Basic,
Basic,
Basic,
Basic,
Basic,
Power,
Power