{
    "definition": [
        "........####....##........",
        "........####....##........",
        "..%%%%####......##........",
        "..%%%%####......##........",
        "%%%%%%%%%%%%%%%%####......",
        "%%%%%%%%%%%%%%%%####......",
        "%%@@##%%######%%%%%%%%##@@",
        "%%..##%%######%%%%%%%%##@@",
        "%%%%##%%%%%%@@%%%%##@.##..",
        "%%%%##%%%%%%..%%%%##@.##..",
        "..%%%%##..%%%%%%%%##..##..",
        "..%%%%##@@%%%%%%%%##..##..",
        "..##########%%%%#####.%%%%",
        "..##########%%%%#####.%%%%",
        ".@@@####......####......%%",
        ".@..####......##........%%",
        "..##..##......##%%%%###.%%",
        "..##..##....##..%%%%###.%%",
        "..##......@@##%%%%##....%%",
        "..##.....###..%%%%##....%%",
        "..#####..###%%%%..%%##%%%%",
        "..#####..###%%%%##%%##%%%%",
        "....##...#......##%%##%%..",
        "....##..%%.!!!!.##%%..%%..",
        "....##..%%.!..!...%%%%%%..",
        "...........!..!...%%%%%%.."
    ],
    "enemyList": [
        "Basic",
        "Basic",
        "Fast",
        "Fast",
        "Fast",
        "Fast",
        "Fast",
        "Fast",
        "Fast",
        "Fast",
        "Fast",
        "Fast",
        "Armor",
        "Armor",
        "Armor",
        "Armor",
        "Armor",
        "Armor",
        "Armor",
        "Armor"
    ]
}