{
    "definition": [
        "..........%%..............",
        "..........%%..............",
        "........%%@@%%............",
        "........%%@@%%............",
        "....%%....%%....%%%%......",
        "....%%....%%....%%%%......",
        "..%%##%%......%%####%%....",
        "..%%##%%......%%####%%....",
        "....%%##%%......%%%%....%%",
        "....%%##%%......%%%%....%%",
        "%%....%%....%%........%%@@",
        "%%....%%....%%........%%@@",
        "##%%......%%@@%%....%%..%%",
        "##%%......%%@@%%....%%..%%",
        "@@##%%......%%....%%@@%%..",
        "@@##%%......%%....%%@@%%..",
        "##%%....%%......%%..%%....",
        "##%%....%%......%%..%%....",
        "%%....%%##%%..%%##%%......",
        "%%....%%##%%..%%##%%......",
        "......%%##%%....%%....%%..",
        "......%%##%%....%%....%%..",
        "..%%....%%..........%%@@%%",
        "..%%....%%.!!!!.....%%@@%%",
        "%%@@%%.....!..!...%%##%%..",
        "%%@@%%.....!..!...%%##%%.."
    ],
    "enemyList": [
        "Fast",
        "Fast",
        "Fast",
        "Fast",
        "Fast",
        "Fast",
        "Fast",
        "Fast",
        "Basic",
        "Basic",
        "Basic",
        "Basic",
        "Basic",
        "Basic",
        "Power",
        "Power",
        "Armor",
        "Armor",
        "Armor",
        "Armor"
    ]
}