{
    "definition": [
        "..........................",
        "..........................",
        "..........@@@@............",
        "..........@@@@............",
        "............@@............",
        "............@@............",
        "..@@@@%%%%##@@##%%%%@@@@..",
        "..@@@@%%%%##@@##%%%%@@@@..",
        "......@@%%%%@@%%%%@@......",
        "......@@%%%%@@%%%%@@......",
        "%%......@@%%%%%%@@......%%",
        "%%......@@%%%%%%@@......%%",
        "@@%%......%%%%%%......%%@@",
        "@@%%......%%%%%%......%%@@",
        "%%........@@%%@@........%%",
        "%%......@@..%%..@@......%%",
        "........@@......@@........",
        "........@@..@@..@@........",
        "......@@....@@....@@......",
        "......@@....@@....@@......",
        "..........................",
        "..........................",
        "..........................",
        "...........!!!!...........",
        "....@@.....!..!.....@@....",
        "....@@.....!..!.....@@...."
    ],
    "enemyList": [
        "Armor",
        "Armor",
        "Armor",
        "Armor",
        "Armor",
        "Armor",
        "Power",
        "Power",
        "Power",
        "Power",
        "Fast",
        "Fast",
        "Fast",
        "Fast",
        "Fast",
        "Fast",
        "Fast",
        "Fast",
        "Fast",
        "Fast"
    ]
}