{
    "definition": [
        "........####..............",
        "........####..............",
        "........##......@@@@@@....",
        "@@..##..##..........@@....",
        "@@..##......##............",
        "@@..##......##............",
        "##..######..####..~~~~..~~",
        "##..######..####..~~~~..~~",
        "##......##........~~......",
        "..................~~......",
        "........~~~~..~~~~~~..####",
        "....##..~~~~..~~~~~~..####",
        "####....~~##..###.........",
        "####....~~##..###.........",
        "........~~...........@@...",
        "........~~...........@@...",
        "~~~~~~..~~..@@..##...@....",
        "~~~~~~..~~..@@..##...@....",
        ".....................@####",
        "......####...........@####",
        "........##########........",
        "........##......####......",
        "######............####....",
        "####.......!!!!.....##....",
        "##.........!..!...........",
        "...........!..!..........."
    ],
    "enemyList": [
        "Power",
        "Power",
        "Power",
        "Power",
        "Power",
        "Armor",
        "Armor",
        "Basic",
        "Basic",
        "Basic",
        "Basic",
        "Basic",
        "Basic",
        "Basic",
        "Basic",
        "Fast",
        "Fast",
        "Fast",
        "Fast",
        "Fast"
    ]
}