{
    "definition": [
        "..............@@@@........",
        "..........................",
        "....@@@@@@@@........@@....",
        "....@@..............@@....",
        "....@@......%%..@@@@@@....",
        "....@@......%%....@@@@....",
        "..@@......%%@@......@@....",
        "..@@......%%@@......@@....",
        "........%%@@@@......@@@@..",
        "........%%@@@@........@@..",
        "..@@..%%@@@@@@..@@........",
        "..@@..%%@@@@@@..@@........",
        "...@..@@@@......@@@@......",
        "...@..@@@@......@@@@......",
        "@.......@@..@@@@@@.....@..",
        "@.......@@..@@@@@@.....@..",
        "...@@@......@@@@%%....@@..",
        "...@@@......@@@@%%....@@..",
        "..@@........@@%%....@@@@..",
        "..@@........@@%%....@@@@..",
        "..@@@@@@....%%....@@......",
        "......@@....%%....@@......",
        "..................@@....@@",
        "...........!!!!.......@@@@",
        "...........!..!...........",
        "@@@@.......!..!..........."
    ],
    "enemyList": [
        "Basic",
        "Basic",
        "Basic",
        "Fast",
        "Fast",
        "Fast",
        "Fast",
        "Power",
        "Power",
        "Power",
        "Power",
        "Power",
        "Power",
        "Basic",
        "Basic",
        "Basic",
        "Basic",
        "Basic",
        "Basic",
        "Basic"
    ]
}